的	rqyy
一	ggll
是	jghu
不	dhi
了	bnh
在	dhfd
有	def
人	wwww
这	ypi
上	hhgg
大	dddd
来	gusi
和	tkg
我	trny
个	whj
中	khk
地	fbn
为	yeyi
他	wbn
生	tgd
要	svf
们	wun
以	nywy
到	gcfj
国	lgyi
时	jfy
就	yidy
出	bmk
说	yukq
会	wfcu
也	bnhn
子	bbbb
学	ipbf
发	ntcy
着	uhf
对	cfy
作	wthf
能	cexx
可	skd
于	gfk
成	dnv
用	etnh
过	fpi
动	fcet
主	ygd
下	ghi
而	dmjj
年	tgj
分	wvr
得	tjgf
家	pgeu
种	tkhh
里	jfd
多	qqu
经	xcag
自	thd
现	gmqn
同	mgkd
后	rgkd
产	ute
方	yygt
工	aaaa
行	tgsh
面	dljf
那	ngbh
小	ihty
所	rnrh
起	fhnv
去	fcu
之	pppp
都	ftjb
然	qdou
理	gjfg
进	fjpk
体	wsgg
还	dhpi
定	pghu
实	pudu
如	vkg
么	tcu
物	cqrt
法	ifcy
你	wqiy
好	vbg
性	ntgg
民	nav
从	wwy
天	gdi
化	wxn
等	tffu
力	ent
本	sgd
长	tayi
心	nyny
把	rcn
部	ukbh
义	yri
样	suh
事	gkvh
看	rhf
业	ohhg
当	ivf
因	ldi
高	ymkf
十	fgh
开	gak
些	hxff
社	pyfg
前	uejj
又	cccc
它	pxb
水	iiii
其	dwu
没	iwcy
想	shnu
意	ujnu
三	dggg
只	kwu
重	tgjf
点	hkou
与	gngd
使	wgkr
但	wjgg
度	oaci
由	mhng
道	uthp
全	wgf
制	tgmj
明	jeg
相	shg
两	gmww
情	ngeg
外	qhy
间	ujd
二	fgg
关	udu
活	itdg
正	ghd
合	wgkf
者	ftjf
形	gaet
应	oigd
头	udi
无	fqv
量	jgjf
表	geu
象	qkeu
气	rtgn
文	yygy
展	naei
系	txiu
代	wayy
加	ekg
各	tkf
很	tvy
教	ftbt
新	usrh
向	tmkd
机	swn
她	vbn
内	mwi
此	hxn
老	ftxb
变	yocu
原	drii
结	xfkg
问	ukd
手	rtgh
日	jjjj
利	tjh
质	rfmi
已	nnnn
最	jbcu
政	ghty
儿	qtn
见	mqb
并	uaj
平	gufk
资	uqwm
比	xxn
特	cffy
果	jsi
什	wfh
建	vgpk
反	rci
常	ipkh
知	tdkg
第	txht
电	jnv
思	lnu
立	uuuu
提	rjgh
或	akgd
通	cepk
解	qevg
身	tmdt
四	lhng
品	kkkf
几	wtn
位	wug
别	kejh
论	ywxn
公	wcu
给	xwgk
少	ite
条	tsu
观	cmqn
回	lkd
海	itxy
基	dwff
次	uqwy
被	puby
山	mmmm
才	fte
己	nngn
期	dweg
西	sghg
术	syi
济	iyjh
认	ywy
先	tfqb
命	wgkb
走	fhu
真	fhwu
员	kmu
及	byi
数	ovty
话	ytdg
门	uyhn
级	xbyy
军	plj
统	xycq
光	igqb
声	fnr
题	jghm
入	tyi
美	ugdu
口	kkkk
感	dgkn
战	hkay
科	tufh
程	tkgg
式	aayi
指	rxjg
世	anv
必	nte
放	yty
打	rsh
接	ruvg
总	uknu
做	wdty
东	aii
区	ari
农	pei
强	xkjy
造	tfkp
类	odu
受	epcu
场	fnrt
五	gghg
直	fhf
月	eeee
流	iyck
决	unwy
干	fggh
则	mjh
更	gjri
色	qcb
处	thi
路	khtk
运	fcpi
任	wtfg
具	hwu
目	hhhh
再	gmfd
治	ickg
神	pyjh
求	giyi
件	wtgh
管	tpnf
组	xegg
根	svy
阶	bwjh
将	uqfy
改	nty
导	nfu
眼	hvy
规	gmqn
识	ykwy
革	afj
计	yfh
白	rrrr
马	cgd
金	qqqq
界	lwjj
取	bcy
市	ymhj
设	ywcy
语	ygkg
完	pfqb
究	pwvb
党	ipkq
女	vvvv
传	wfny
风	wri
信	wyg
名	qkf
便	wgjr
保	wksy
育	ycef
队	bwy
带	gkph
叫	knhh
研	dgah
领	wycm
北	uxn
较	lury
张	xtay
即	vbh
至	gcff
许	ytfh
步	hhr
往	tygg
听	krh
调	ymfk
务	ter
花	awxb
争	qvhj
线	xgay
呢	knxn
每	txu
边	epe
难	cwyg
太	dyi
共	awu
交	uru
确	dqeh
劳	aper
据	rndg
达	dpi
住	wygg
收	nhty
候	whnd
需	fdmj
转	lfny
百	djf
南	fmuf
清	igeg
格	stkg
影	jyie
书	nnhy
切	avt
且	egd
却	fcbh
志	fnu
热	rvyo
联	budy
安	pvf
极	sbyy
今	wynb
单	ujfj
商	yumk
料	oufh
技	rfcy
深	ipws
验	cgwg
增	fulj
记	ynn
近	rpk
言	yyyy
整	skth
精	ogeg
集	wysu
空	pwaf
连	lpk
报	rbcy
觉	ipmq
车	lgnh
价	wwjh
音	ujf
响	ktmk
办	ewi
存	dhbd
怎	thfn
病	ugmw
快	nnwy
图	ltui
况	ukqn
例	wgqj
消	iieg
容	pwwk
史	kri
非	hdhd
离	yrbc
节	abj
亲	usu
万	gqe
八	wty
构	sqcy
族	yttd
石	dgtg
满	iagw
何	wskg
广	oygt
律	tvgh
青	gef
林	ssy
克	dqb
王	gggg
历	dee
权	scy
素	gxiu
始	vckg
断	onrh
九	vtn
际	bfiy
积	tkwy
吃	ktnn
态	dynu
艺	anb
证	yghg
众	wwwu
创	wbjh
红	xag
望	yneg
须	edmy
群	vtku
师	jgmh
该	yynw
复	tjtu
细	xlg
包	qnv
土	ffff
持	rffy
服	ebcy
笑	ttdu
德	tfln
般	tuwc
远	fqpv
爱	epdc
准	uwyg
写	pgng
算	thaj
火	oooo
死	gqxv
半	ugk
布	dmhj
随	bdep
六	uygy
元	fqb
低	wqay
称	tqiy
引	xhh
照	jvko
失	tgi
养	ugjj
视	pymq
习	nud
段	thdc
字	pbf
织	xkwy
斗	ufk
团	lfte
器	kkdk
兴	igwu
乐	tnii
效	urty
显	jof
斯	dwrh
千	tfk
落	aitk
示	fiu
仅	wcy
企	whf
似	wnyw
备	tlf
除	bwgs
支	fcu
标	sfiy
早	jhnh
吧	kcn
周	mfkd
速	skpd
跟	khvy
七	agn
采	esu
状	udy
吗	kcgg
约	xqyy
城	fdnn
层	nfci
专	fnyi
划	ajh
轻	lcag
拉	rug
值	wfhg
适	tdpd
英	amdu
告	tfkf
讲	yfjh
维	xwyg
营	apkk
士	fghg
环	gdhy
古	dghg
让	yhg
院	bpfq
按	rpvg
型	gajf
势	rvye
足	khu
毛	etgn
台	ckf
紧	jcxi
片	thgn
属	ntky
严	gote
树	scfy
画	glbj
厂	dgt
功	aet
注	iygg
演	ipgw
源	idri
温	ijlg
某	fsu
找	ray
参	cder
易	jqrr
飞	nui
推	rwyg
围	lfnh
列	gqjh
客	ptkf
河	iskg
虽	kju
境	fujq
食	wyvu
李	sbf
尔	qiu
黄	amwu
黑	lfou
念	wynn
越	fhan
选	tfqp
华	wxfj
角	qej
考	ftgn
致	gcft
夫	gggy
初	puvt
装	ufye
议	yyry
首	uthf
委	tvf
底	oqay
另	ker
江	iag
息	thnu
密	pntm
压	dfyi
孩	bynw
村	sfy
费	xjmu
局	nnkd
派	irey
房	ynye
星	jtgf
突	pwdu
供	wawy
曾	uljf
排	rhdd
苦	adf
够	qkqq
像	wqke
站	uhkg
校	sury
富	pgkl
谈	yooy
米	oyty
充	ycqb
阳	bjg
破	dby
母	xnny
球	ggiy
射	tmdf
批	rxxn
配	sgnn
纪	xnn
未	fggy
哪	kngb
妈	vcgg
差	uaf
刚	mrjh
率	yxif
察	pwfi
舞	tglg
依	wyey
占	hkf
呀	kaht
微	tmgt
础	dbmh
益	uwlf
倒	wgcj
刻	yntj
举	igwg
血	tld
故	dty
互	gxd
范	aibb
木	ssss
号	kgnb
尽	nyuu
请	ygeg
脸	ewgg
兵	rwu
职	bkwy
留	qyvl
铁	qtgy
吸	kbyy
钱	qgay
急	qvnu
独	qtjy
剧	ndjh
查	sjgf
皮	bnty
激	iryt
坐	wwfd
乎	tufk
固	ldd
害	pdhk
夜	ywty
续	xfnd
京	yiu
双	ccy
拿	wgkr
府	owfi
限	bvy
草	ajj
项	admy
述	sypi
曲	mad
既	vaqn
春	dwjf
官	pnf
坚	jcff
令	wycu
句	qkd
助	eget
简	tujf
杂	vsu
材	sftt
封	fffy
护	rynt
司	ngkd
省	ithf
县	egcu
模	sajd
试	yaay
绝	xqcn
洋	iuh
谁	ywyg
继	xonn
止	hhgg
喜	fkuk
优	wdny
词	yngk
陈	baiy
鱼	qgf
终	xtuy
施	ytbn
晚	jqkq
朝	fjeg
含	wynk
仍	wbt
脑	eyrb
甚	dwnb
汉	icy
修	whte
油	img
衣	yeu
击	gbk
云	fcu
送	udpi
巴	cnhn
普	uojf
征	tghg
错	qajg
均	fqug
投	rwcy
波	iby
余	wgsu
友	dcu
武	gahy
责	gmu
游	iytb
敌	tdty
叶	kfh
船	tuwk
久	qyi
否	dhkf
异	naj
块	fnwy
脚	efcb
怕	nrg
田	llll
策	tsmb
苏	aewu
乡	xte
帝	yuph
靠	tfkd
医	atdi
测	imjh
植	sfhg
啊	kbsk
括	rtdg
换	rqmd
逐	gepi
娘	vyvy
罗	lqu
戏	cay
善	uukf
获	aqtd
待	tffy
降	btgh
冲	ukhh
父	wru
置	lfhf
左	daf
右	dkf
沉	ipwn
酸	sgct
亮	ypwb
良	yvi
班	gytg
著	aftj
亚	god
抗	rywn
啦	krug
静	geqh
渐	ilrh
概	svaq
居	ndd
跑	khqn
旧	hjg
防	byt
买	nudu
挥	rplh
负	qmu
帮	dtbh
欢	cqwy
冷	uwyc
液	iywy
停	wyps
减	udgk
男	ler
胜	etgg
答	twgk
析	srh
忙	nynn
短	tdgu
烈	gqjo
映	jmdy
财	mftt
背	uxef
奇	dskf
药	axqy
承	bdii
岁	mqu
略	ltkg
穿	pwat
牛	tgk
室	pgcf
移	tqqy
饭	qnrc
坏	fdhy
假	wnhc
州	ytyh
缺	tfbw
愿	drin
练	xanw
超	fhvk
雨	fghy
慢	njlc
竟	ujqb
呼	ktuf
散	aety
灵	vou
副	gklj
歌	sksw
谓	yleg
虫	jhny
读	yfnd
介	wjj
培	fukg
卫	bgd
宗	pfiu
章	ujj
评	yguf
伤	wtet
丰	dhk
核	synw
预	cnhm
担	rjgg
诉	yryy
惊	nyiy
刘	yjh
景	jyiu
乱	tdnn
氧	ruk
阿	bskg
龙	dxyi
宣	pgjg
升	tak
爷	wrbj
洲	iyth
判	ugjh
案	pvsu
协	fewy
福	pygl
货	wxmu
味	kfy
若	adkf
促	wkhy
希	rdmh
握	rngf
端	umdj
针	qfh
屋	ngcf
掌	ipkr
检	swgg
痛	ucek
闻	ubd
妇	vvg
贵	khgm
顾	dbdm
沙	iitt
扩	rot
困	lsi
哥	sksk
嘴	khxe
销	qieg
印	qgbh
免	qkqb
烟	oldy
跳	khqi
香	tjf
纸	xqan
户	yne
板	srcy
睛	hgeg
误	ykgd
探	rpws
座	owwf
盾	rfhd
灯	osh
搞	rymk
祖	pyeg
顺	kdmy
婚	vqaj
赶	fhfk
季	tbf
兰	udf
忽	qrnu
践	khga
熟	ybvo
矛	cnht
银	qvy
爸	wrcb
临	jtyj
佛	wxjh
犯	qtbn
胞	eqnn
讨	yfy
陆	bgbh
补	puhy
童	ujff
圆	lkmi
归	jvg
弟	uxht
域	fakg
索	fpxi
罪	lhdd
脱	eukq
追	tnpd
守	pfu
课	yjsy
顶	sdmy
松	swcy
杀	rsu
掉	rhjh
野	jfch
训	ykh
遍	ynmp
庭	otfp
弱	xuxu
赛	pawm
额	ptkm
酒	isgg
绿	xviy
席	oamh
露	fkhk
卖	fnud
钟	qkhh
旁	yupy
肉	mwwi
央	mdi
染	ivsu
欧	arqw
怀	ndhy
稳	tqvn
伯	wrg
编	xyna
抓	rrhy
玉	gyi
咱	kthg
唯	kwyg
唱	kjjg
翻	toln
释	tocg
控	rpwa
怪	ncfg
阵	blh
烧	oatq
堂	ipkf
杨	snrt
您	wqin
诗	yffy
灭	goi
夏	dhtu
敢	nbty
退	vpi
姑	vdg
恶	gonu
透	tbpe
鲜	qguh
附	bwfy
骨	mef
审	pjhj
胡	deg
输	lwgj
宁	psj
丝	xxgf
姐	vegg
彩	eset
睡	htgf
巨	and
迫	rpd
鼓	fkuc
伙	woy
借	wajg
耳	bghg
典	mawu
刺	smjh
暗	jujg
镜	qujq
序	ocnh
哈	kwgk
菜	aesu
溶	ipwk
笔	teb
汽	irn
礼	pynn
摇	retb
迅	nfpk
险	bwgg
遗	khgp
威	dgvd
沿	iwkg
弹	xujf
私	tcy
攻	aty
宝	pgyu
抽	rmg
雪	fvf
孙	biy
藏	aauh
毒	gxu
顿	gbnm
末	gsi
摆	rlfc
趣	fhbc
救	giyt
镇	qfhw
楼	sovg
智	tdkj
园	lfqv
康	ovii
永	ynii
遇	jmhp
雄	dcwy
替	ggjf
危	qdbb
楚	ssnh
侵	wvpc
枪	swbn
冰	uiy
健	wvgp
播	rtol
途	wgsp
损	rkmy
秀	tbr
丽	gmyy
秋	toy
执	rvyy
束	skd
纳	xmwy
虑	hni
疑	xtdh
午	tfj
粮	oyvy
架	eksu
盛	dnlf
湖	ideg
尚	imkf
床	osi
份	wwvt
套	ddu
毫	ypeb
奋	dlf
扬	rnrt
赵	fhri
混	ijxx
献	fmud
择	rcgh
庄	ofd
殖	gqfh
店	ohkd
皇	rgf
购	mqcy
缩	xpwj
盐	fhlf
冬	tuu
齐	yjj
径	tcag
偏	wyna
盖	uglf
款	ffiw
衡	tqds
阻	begg
托	rtan
喊	kdgk
繁	txti
纯	xgbn
牙	ahte
殊	gqtf
浪	iyvy
招	rvkg
符	twfu
折	rrh
泽	icgh
弄	gaj
奶	vbt
谢	ytmf
累	lxiu
亦	you
厚	djbd
朋	eeg
伸	wjhh
筑	tawy
闪	uwi
枝	sfcy
授	repc
蛋	nhju
潮	ifje
登	wgku
售	wykf
孔	bnn
街	tffs
败	mty
迎	qbpk
肥	ecn
恩	ldnu
尼	nxv
幼	xet
惯	nxmy
钢	qmry
肯	hef
矿	dot
岛	qmk
伟	wfnh
粉	owvt
振	rdfe
吴	kgdu
夺	dfu
尤	dnyi
忘	ynnu
荣	apsu
亡	ynv
阴	beg
凡	wyi
毕	xxfj
暴	jawi
唐	ovhk
勇	ceer
避	nkup
麻	ossi
股	ewcy
硬	dgjr
洞	imgk
盘	tulf
轮	lwxn
警	aqky
闹	uymh
录	viu
绍	xvkg
描	ralg
寻	vfu
妹	vfy
幸	fufj
壁	nkuf
距	khan
玩	gfqn
休	wsy
延	thnp
综	xpfi
甲	lhnh
泛	itpy
哲	rrkf
载	fald
雷	flf
窗	pwtq
虚	hod
秘	tntt
俗	wwwk
倾	wxdm
哭	kkdu
禁	ssfi
零	fwyc
触	qejy
巧	agnn
圈	lugb
努	vcer
喝	kjqn
彻	tavt
晶	jjjf
丁	sgh
操	rkks
奴	vcy
宜	pegf
菌	altu
叔	hicy
桥	stdj
仿	wyt
默	lfod
航	tuyw
谷	wwkf
泪	ihg
予	cnhj
挂	rffg
壮	ufg
纷	xwvt
粒	oug
燃	oqdo
诸	yftj
削	iejh
苗	alf
婆	ibvf
付	wfy
迷	opi
馆	qnpn
灰	dou
鸡	cqgg
岸	mdfj
寒	pawu
泥	inxn
梅	stxy
残	gqga
税	tukq
虎	hwv
庆	odi
抱	rqnn
鸟	qgd
拍	rrg
墙	ffuk
缓	xegc
横	samw
尾	nev
督	hich
莫	ajdu
械	saah
尖	idu
旅	ytey
倍	wukg
措	rajg
剥	vijh
遭	gmap
懂	natf
粗	oegg
奏	dwgd
润	iugg
侧	wmjh
辩	uyuh
茶	awsu
鬼	rqci
梦	ssqu
贯	xmu
篇	tyna
妻	gvhv
宽	pamq
腿	evpy
刀	vnt
桌	hjsu
浓	ipey
跃	khtd
蹈	khee
洗	itfq
卷	ugbb
欲	wwkw
袋	waye
赏	ipkm
悲	hdhn
劲	caet
鲁	qgjf
赞	tfqm
氏	qav
汇	ian
迹	yopi
竞	ukqb
醒	sgjg
裂	gqje
闭	ufte
森	sssu
腰	esvg
磁	duxx
湿	ijog
聚	bciu
兄	kqb
徐	twgs
炼	oanw
订	ysh
川	kthh
吹	kqwy
蒙	apfe
胸	eqrb
召	vkf
伴	wugh
徒	tfhy
幅	mhgl
疗	ubk
淡	iooy
奖	uqdu
仪	wyry
珠	gtfy
绪	xftj
蒋	auqf
猪	qtfj
剂	yjjh
访	yyt
狗	qtqk
摸	rajd
趋	fhqv
宋	psu
伏	wdy
棉	srmh
恐	awyn
羊	uyth
碳	dmdo
隔	bgkh
网	mrri
猛	qtbl
爬	rhyc
缘	xxey
麦	gtu
库	olk
津	ivgh
监	jtyl
薄	aisf
净	uqvh
旋	ytnh
贫	wvmu
罢	lfcu
穷	pwer
乏	tpu
挑	rqiy
废	onty
汗	ifh
耗	fsen
尊	usgf
牌	thgf
抢	rwbn
软	lqwy
隶	vii
宇	pgfj
圣	cff
港	iawn
欣	rqwy
塞	pawf
刑	gajh
博	fsfy
揭	rjqn
垂	tgaf
姓	vtgg
捕	rsy
荒	aynk
诚	ydnn
炮	oqnn
呈	kgf
辑	lkbg
卡	hhu
伦	wwxn
蓝	ajtl
抬	rckg
宫	pkkf
敬	aqkt
版	thgc
忍	vynu
颜	utem
竹	thth
碰	duog
启	ynkd
票	sfiu
隐	bqvn
抵	rqay
脉	eyni
浮	iebg
煤	ofsy
剩	tuxj
珍	gwet
奔	dfaj
堆	fwyg
扎	rnn
谋	yfsy
貌	erqn
脏	eofg
逃	qipi
洪	iawy
旗	ytdw
潜	iggj
鼻	thlj
忆	nnn
湾	iyox
绩	xgmy
恰	nwgk
坦	fjgg
怒	vcnu
震	fdfe
豆	gkuf
插	rtfe
戴	falw
涉	ihht
绘	xwfc
瓦	gnny
龄	hwbc
池	ibn
沟	iqcy
呵	kskg
伍	wgg
氢	rcad
拥	reh
乘	tuxv
吉	fkf
尺	nyi
朱	tfi
蒸	abio
舍	wfkf
贡	amu
糊	odeg
梁	ivws
漫	ijlc
腾	eugg
症	ughd
丈	dyi
钻	qhkg
磨	ossd
井	fjk
艰	cvy
键	qvgp
绕	xatq
幕	ajdh
斤	rtth
污	ifnn
贝	mhny
冒	jhf
阔	uitd
胆	ejgg
渡	ioac
碍	djgf
崇	mpfi
愈	wgen
岩	mdf
玻	gby
碎	dywf
宪	ptfq
俄	wtry
障	bujh
融	gkmj
贸	qyvm
耐	dmjf
届	nmd
寄	pdsk
荡	ainr
币	tmhk
俩	wgmw
卵	qyty
弃	ycaj
悄	nieg
偶	wjmy
纵	xwwy
陷	bqeg
坡	fby
勤	akge
享	ybf
塑	ubtf
膜	eajd
铜	qmgk
拖	rtbn
暖	jegc
稍	tieg
摩	ossr
硫	dyck
哩	kjfg
乌	tnng
循	trfh
妙	vitt
疾	utdi
肩	yned
炎	oou
偷	wwgj
赤	fou
灾	pou
恒	ngjg
孤	brcy
仁	wfg
腔	epwa
杯	sdhy
乃	bnt
稀	trdh
恢	ndoy
违	fnhp
伊	wvtt
挺	rtfp
乙	nnll
拜	rdfh
焦	wyou
锋	qtdh
铺	qsy
颗	jsdm
滑	imeg
敏	txty
洁	ifkg
嘛	koss
凝	uxth
凉	uyiy
杜	sfg
凭	wtfw
勒	afet
爆	ojai
递	uxhp
鞋	afff
迁	tfpk
秦	dwtu
桂	sffg
璃	gyrc
摄	rbcc
叹	kcy
峰	mtdh
牧	cty
恨	nvy
糖	oovk
骂	kkcg
贴	mhkg
紫	hxxi
壤	fyke
辛	uygh
仰	wqbh
腐	owfw
割	pdhj
辈	hdhl
君	vtkf
泡	iqnn
郭	ybbh
呆	ksu
番	tolf
励	dgqe
乳	ebnn
亿	wnn
兼	uvjw
昨	jthf
刊	fjh
擦	rpwi
迟	nypi
拔	rdcy
丹	myd
彼	tby
搬	rtuc
眉	nhd
滴	iyud
朵	wsu
畜	yxlf
遵	usgp
逻	lqpi
患	kkhn
奥	tmod
耕	fsfj
忠	khnu
鉴	jtyq
挤	ryjh
滚	iuce
壳	fpwb
厅	dsk
旦	jgf
炸	othf
塔	fawk
频	hhdm
弯	yoxb
狂	qtgg
陶	bqtb
晓	jatq
柳	sqtb
炉	oynt
宏	pdcu
愤	nfam
瞧	hwyo
箱	tshf
扑	rhy
暂	lrjf
盆	wvlf
瓶	uagy
柱	sygg
辉	igql
雅	ahty
衰	ykge
洛	itkg
朗	yveg
琴	ggwn
腹	etjt
牲	ctgg
黎	tqti
肃	vhjw
雾	fter
冠	pfqf
伪	wyey
幻	xnn
仔	wbg
杰	sou
烦	odmy
悟	ngkg
荷	awsk
晨	jdfe
甘	fghg
饱	qnqn
飘	sfir
芳	ayr
肌	ewn
舒	wfkh
惜	najg
丧	fueu
肚	efg
灌	iaky
抑	rqbh
鸣	kqgg
辞	tduh
宙	pmf
邻	wycb
昌	jjf
扫	rvg
赖	skqm
泉	riu
肠	enrt
鼠	enun
援	regc
墨	lfof
啥	kwfk
祥	pyuh
储	wyfj
萨	abut
裁	faye
奉	dwgj
傅	wsfy
姿	uqwv
埋	fjfg
亩	ylf
犹	qtdy
瓜	rcyi
咬	kury
粘	ohkg
芽	aaht
吐	kfg
昆	jxxb
估	wdg
租	tegg
碗	dpqb
轨	lvn
稻	teeg
纲	xmry
役	twcy
勃	fpbe
毁	eawc
烂	oudg
昏	qajf
隆	btgg
饰	qnth
曹	gmaj
仙	wmh
夹	gudi
爹	wrqq
郑	udbh
闲	usi
柔	cnhs
吓	kghy
嫂	vehc
巩	awyy
亏	fnb
帽	mhjh
浅	igay
详	yuh
斜	wgsf
佳	wffg
饮	qnqw
猫	qtal
杆	sfh
恋	yonu
凤	wci
缝	xtdp
疏	nhyk
扶	rgy
厉	dgqe
喷	kfam
截	fawy
扰	rdny
拨	rnty
雕	mfky
码	dcgg
瑞	gmdj
讯	ynfh
莲	alpu
邦	dtbh
贷	waym
丢	tfcu
慌	nayk
寿	dtfu
毅	uewc
漂	isfi
屈	nbmk
涂	iwgs
蜂	jtdh
猎	qtaj
氯	rvii
劝	cet
柴	hxsu
悉	tonu
狠	qtvy
岗	mmru
饲	qnnk
祝	pykq
皆	xxrf
罚	lyjj
躺	tmdk
桃	sqiy
猴	qtwd
宿	pwdj
锅	qkmw
胶	eury
偿	wipc
宾	prwu
译	ycgh
袭	dxye
串	kkhk
申	jhk
捉	rkhy
挖	rpwn
窝	pwkw
踏	khij
邓	cbh
允	cqb
舌	tdd
溜	iqyl
驻	cgyg
膀	eyuy
渔	iqgg
纠	xnhh
冻	uaiy
扭	rnhg
臣	ahnh
埃	fctd
辐	lgkl
闷	uni
涨	ixty
签	twgg
秒	titt
贺	ekmu
耀	igqy
辨	uytu
燕	akuo
慰	nfin
颇	bdmy
债	wgmy
肺	egmh
逼	gklp
魂	fcrc
匆	qryi
旺	jgg
姻	vldy
吞	gdkf
甜	tdfg
吨	kgbn
搭	rawk
屏	nuak
掩	rdjn
涌	iceh
袁	fkeu
汤	inrt
岭	mwyc
拟	rnyw
慧	dhdn
郎	yvbh
瘦	uehc
阅	uukq
辆	lgmw
填	ffhw
袖	pumg
匀	qud
娃	vffg
筒	tmgk
豪	ypge
籍	tfsj
餐	hqcv
轰	lccu
尘	iff
敲	ymkc
帐	mhty
撞	rujf
钠	qmwy
牢	ptgj
肿	ekhh
盲	ynhf
腊	eajg
锐	qukq
返	rcpi
骗	cgya
骑	cgdk
扣	rkg
寺	ffu
沈	ipqn
醉	sgyf
纹	xyy
纺	xyt
泰	dwiu
盟	jelf
辟	nkuh
丛	wwgf
拒	rang
忧	ndny
魏	tvrc
躲	tmds
纤	xtfh
肖	ief
悬	egcn
旱	jfj
晋	gojf
祭	wfiu
誉	igwy
谱	yuoj
箭	tuej
狭	qtgd
饿	qnty
驱	cgar
冯	ucgg
脂	exjg
斥	ryi
肤	egy
椅	sdsk
栽	fasi
仗	wdyy
墓	ajdf
舅	eler
碱	ddgk
兽	ulgk
锁	qimy
喂	klge
抛	rvet
苍	awbb
臂	nkue
溪	iexd
胖	eugh
伐	way
汪	igg
刷	nmhj
稿	tymk
绳	xkjn
剪	uejv
唤	kqmd
凶	rbk
邮	mbh
齿	hwbj
尝	ipfc
漠	iajd
怨	qbnu
络	xtkg
撤	ryct
撒	raet
筹	tdtf
幽	mxxi
渗	icde
蛇	jpxn
诱	ytbt
抚	rfqn
磷	doqg
逆	ubtp
牵	dptg
诊	ywet
惨	ncde
抖	rufh
庙	omd
株	stfy
浑	iplh
驶	cgkr
泼	inty
厌	ddi
怜	nwyc
疲	ubi
厘	djfd
叙	wgsc
嫁	vpge
跨	khdn
惠	gjhn
哀	yeu
胃	lef
蜜	pntj
梯	suxt
诺	yadk
悠	whtn
滩	icwy
笼	tdxy
添	igdn
陪	bukg
挨	rctd
拳	ugrj
晃	jigq
寂	phic
倡	wjjg
催	wmwy
朴	shy
郁	debh
脊	iwef
扇	ynnd
仓	wbb
魔	ossc
哎	kary
蓄	ayxl
棵	sjsy
胀	etay
眠	hnan
劣	iter
秩	ttgy
塘	fovk
孟	blf
媳	vthn
廷	tfpd
铃	qwyc
胎	eckg
抹	rgsy
吵	kitt
肢	efcy
拾	rwgk
聪	bukn
寨	paws
翠	nywf
赫	fofo
尿	nii
疼	utui
览	jtyq
狼	qtyv
轴	lmg
锦	qrmh
夸	dfnb
剑	wgij
牺	csg
翼	nlaw
卧	ahnh
曼	jlcu
姆	vxy
匠	ark
熊	cexo
搜	rehc
盈	bclf
覆	sttt
唇	dfek
驾	ekcg
腺	eriy
辅	lsy
枯	sdg
鞭	afwr
翅	fcnd
喘	kmdj
肝	efh
掘	rnbm
歪	dhgh
欺	dwqw
疆	xfgg
赋	mgay
婶	vpjh
畅	jhnr
葡	aqsu
脾	ertf
哼	kybh
柜	sang
兔	qkqy
顽	fqdm
藻	aiks
鸭	lqgg
页	dmu
谐	yxxr
侦	whmy
仇	wvn
睁	hqvh
茫	aiyn
拼	ruah
炭	mdou
锡	qjqr
弦	xyxy
滋	iuxx
锻	qthc
脆	eqdb
裤	puol
卢	hnr
萌	ajef
骤	cgbi
悦	nukq
氮	rooi
葬	agqa
棒	sdwg
渠	ians
诞	ythp
斑	gygg
浩	itfk
盒	wgkl
遥	etfp
颤	ylkm
扮	rwvt
扯	rhg
颈	cadm
玲	gwyc
丑	nhgg
摊	rcwy
桑	cccs
盗	uqwl
柏	srg
唉	kctd
戒	aak
凌	ufwt
羽	nnyg
胁	eewy
捷	rgvh
皱	qvby
堡	wksf
嚷	kyke
挣	rqvh
淋	issy
陵	bfwt
彭	fkue
茂	adu
吊	kmhj
愁	tonu
巡	vpv
寸	fghy
纱	xitt
惑	akgn
董	atgf
勾	qci
昂	jqbj
阐	uujf
纬	xfnh
逢	tdhp
披	rby
恼	nyrb
佩	wwgh
妥	evf
萄	aqtb
迈	gqpe
坛	ffcy
署	lftj
姨	vgxw
肾	jcef
仲	wkhh
邀	rytp
莱	agus
辽	bpk
阀	uwai
猜	qtge
弥	xqiy
瞪	hwgu
韩	fjfh
臭	thdu
脖	efpb
掏	rqtb
妨	vyt
燥	okks
酷	sgtk
蚁	jyry
鸿	iaqg
棚	seeg
芦	aynr
漏	infy
凯	mnwn
浸	ivpc
舰	tumq
狱	qtyd
踪	khpi
氛	rwve
摘	ryud
御	ttgb
蔡	awfi
扔	rbt
硝	dieg
裕	puwk
氨	rpvd
竭	ujqn
蚕	gdju
疯	uwri
坑	fywn
愉	nwgj
矮	tdtv
嘉	fkuk
掠	ryiy
泄	iann
叉	cyi
渴	ijqn
冶	uckg
囊	gkhe
辣	uskg
菊	aqou
凑	udwd
歇	jqww
嘻	kfkk
雇	ynwy
婴	mmvf
泌	intt
痕	uvi
亭	ypsj
跌	khtg
夕	qtny
册	mmgd
螺	jlxi
贮	mpgg
淀	ipgh
贪	wynm
庞	odxy
铝	qkkg
砖	dfny
僚	wdui
涛	idtf
耶	bbh
艳	dhqc
玛	gcgg
拆	rryy
绵	xrmh
遮	oaop
慎	nfhw
贾	smu
贤	jcmu
糟	ogmj
鹿	oxxv
霸	fafe
匹	aqv
挡	rivg
舱	tuwb
咳	kynw
雀	iwyf
赴	fhhi
蚀	qnjy
咽	kldy
饥	qnwn
鹰	owwg
询	yqjg
嘿	klfo
函	bibk
堪	fdwn
嗓	kccs
嫩	vskt
晴	jgeg
蹲	khuf
辖	lpdk
豫	cnhe
酬	sgyh
剖	ukjh
钾	qlh
尸	nngt
胚	edhg
悔	ntxy
雌	hxwy
哦	ktry
惩	tghn
漆	iswi
篮	tjtl
链	qlpy
筋	teer
摔	ryxf
遂	uepi
叠	cccg
霍	fwyf
垄	dxyf
匪	ahdd
侯	wntd
巾	mhk
贞	hmu
丘	rthg
滞	igkh
洒	isg
纽	xnhg
蓬	atdp
浙	irrh
潘	itol
娜	vngb
矩	tdan
闯	ucgd
盼	hwvt
叛	ugrc
履	nttt
霞	fnhc
菲	ahdd
瞬	hepg
奸	vfh
砍	dqwy
敦	ybty
浆	uqiu
儒	wfdj
拓	rdg
僧	wulj
棋	sdwy
芬	awvr
俺	wdjn
慈	uxxn
萧	avhw
蛮	yoju
郊	urbh
勉	qkqe
钉	qsh
缠	xojf
盯	hsh
吾	gkf
咕	kdg
膨	efke
堵	fftj
卜	hhy
扁	ynma
葛	ajqn
哟	kxqy
寡	pdev
鄂	kkfb
驰	cgbn
桶	sceh
晒	jsg
慕	ajdn
栏	sudg
霜	fshf
谊	ypeg
哇	kffg
畴	ldtf
隙	biji
孝	ftbf
押	rlh
竖	jcuf
喉	kwnd
欠	qwu
衫	puet
吕	kkf
旬	qjd
韵	ujqu
霉	ftxu
邪	ahtb
孕	bbf
穆	trie
硅	dffg
峡	mgud
湘	ishg
澳	itmd
羞	unhg
惧	nhwy
慨	nvaq
穴	pwu
捞	rape
辱	dfef
棍	sjxx
撑	ripr
炕	oywn
窄	pwtf
崖	mdff
俱	whwy
宅	ptab
陕	bgud
爽	drrr
鹅	trng
晰	jsrh
绰	xhjh
巢	vjsu
绒	xadt
疫	uwci
茎	acaf
苹	aguf
捧	rdwg
忌	nnu
搏	rsfy
奈	dfiu
躯	tmdr
惹	adkn
焰	oqeg
岂	mnb
甫	sghy
艾	aru
拦	rudg
趁	fhwe
缚	xsfy
祸	pykw
橡	sqke
碧	grdf
卑	rtfj
攀	srrr
饼	qnua
蔬	anhk
譬	nkuy
灶	ofg
赔	mukg
粪	oawu
颠	fhwm
曰	jhng
媒	vfsy
殿	nawc
蛙	jffg
衬	pufy
钩	qqcy
逝	rrpk
哑	kgog
艇	tutp
罩	lhjj
裸	pujs
岳	rmj
庸	oveh
嫌	vuvw
窃	pwav
涵	ibib
砂	ditt
梨	tjsu
泊	irg
遣	khgp
熔	opwk
廉	ouvw
傲	wgqt
傻	wtlt
畏	lgeu
缴	xryt
钙	qghn
铅	qwkg
乔	tdjj
懒	nskm
萍	aigf
莉	atjj
挽	rqkq
凄	ugvv
刮	tdjh
卓	hjj
档	sivg
妄	ynvf
劫	fcet
阁	utkd
掀	rrqw
哗	kwxf
藤	aeui
吟	kwyn
杏	skf
颂	wcdm
梢	sieg
罕	pwfj
沸	ixjh
滨	iprw
翔	ung
汁	ifh
戈	agny
愚	jmhn
枉	sgg
秧	tmdy
抒	rcnh
弊	itaj
姜	ugvf
拘	rqkg
贩	mrcy
框	sagg
屁	nxxv
喻	kwgj
嘱	knty
垫	rvyf
迪	mpd
契	dhvd
弗	xjk
瑶	getb
赌	mftj
堤	fjgh
哄	kawy
旨	xjf
晕	jplj
凳	wgkw
址	fhg
彪	hwee
踢	khjr
俊	wcwt
韦	fnhk
贼	madt
稚	twyg
蝶	jans
账	mtay
凹	hnhg
帕	mhrg
携	rwyb
茅	acnt
枢	sary
溃	ikhm
哨	kieg
枚	sty
驳	cgrr
歧	hfcy
抄	ritt
弓	xngn
稼	tpge
颁	wvdm
徽	tmgt
杠	sag
泳	iyni
蜡	jajg
吻	kqrt
沾	ihkg
绣	xtbt
叮	ksh
谨	yakg
厨	dgkf
拐	rket
宴	pjvf
鸦	ahtg
衷	ykhe
戚	dhii
粹	oywf
碑	drtf
煮	ftjo
蕾	aflf
淑	ihic
逸	qkqp
翁	wcnf
倘	wimk
恳	vnu
逊	bipi
趟	fhik
讼	ywcy
衍	tigs
蔽	aitu
胳	etkg
罐	tfby
裙	puvk
龟	qjnb
奠	usgd
颌	wgkm
驴	cgyn
撕	rdwr
蒂	ayuh
姚	vqiy
滥	ijtl
恭	awnu
耻	bhg
蕴	axjl
骄	cgtj
煌	orgg
冤	pqky
瞎	hpdk
娇	vtdj
杭	sywn
倦	wugb
愧	nrqc
淮	iwyg
柯	sskg
聊	bqtb
侨	wtdj
萝	alqu
惟	nwyg
谅	yyiy
瘤	uqyl
蚂	jcgg
崔	mwyf
廊	oyvb
溉	ivaq
铸	qdtf
髓	medp
碌	dviy
拢	rdxy
沫	igsy
帅	jmhh
坟	fyy
娱	vkgd
吏	gkri
峻	mcwt
昼	nyjg
歉	uvjw
刹	rsjh
坝	fmy
栖	ssg
捐	rkeg
渊	itoh
傍	wyuy
叭	kwy
鸽	wgkg
淘	iqtb
轿	ltdj
呜	ktng
宰	puj
谦	yuvw
玄	yxu
丙	gmwi
愣	nlyt
朽	sgnn
跪	khqb
券	ugvr
寓	pjmy
捏	rjfg
搅	ripq
笨	tsgf
槽	sgmj
咋	kthf
厦	ddht
爪	rhyi
奎	dfff
榜	syuy
屠	nftj
耸	wwbf
驼	cgpx
甩	env
逮	vipi
殷	rvnc
赚	muvw
歼	gqtf
孢	bqnn
僵	wglg
矣	ctdu
锤	qtgf
浴	iwwk
呐	kmwy
兹	uxxu
坎	fqwy
珊	gmmg
苯	asgf
垦	vff
兜	rqnq
禅	pyuf
芝	apu
吁	kgfh
酶	sgtx
舆	elgw
惶	nrgg
咐	kwfy
瓷	uqwy
陌	bdjg
颖	xtdm
帘	pwmh
摧	rmwy
赢	yemy
裹	yjse
瞅	htoy
卸	tghb
兆	qii
咧	kgqj
噢	ktmd
仆	why
膊	esfy
醇	sgyb
饶	qnaq
嗯	kldn
篷	ttdp
膝	eswi
肪	eyt
寞	pajd
挫	rwwf
俯	wowf
桔	sfkg
蚊	jyy
熙	ahko
巷	awnb
眨	htpy
烛	ojy
踩	khes
缸	tfba
屯	gbnv
顷	xdmy
鼎	hndn
砸	damh
乾	fjtn
咸	dgkd
沃	itdy
衔	tqgs
俘	webg
熬	gqto
喇	kskj
芒	aynb
钓	qqyy
侍	wffy
禽	wyrc
桩	sofg
灿	omh
吼	kbnn
泣	iug
讽	ywry
凸	hghg
谭	ysjh
敞	imkt
聘	bmgn
哺	ksy
癌	ukkm
浦	isy
躁	khks
卿	qtvb
勘	dwne
窜	pwkh
溢	iuwl
舟	tui
楞	slyt
虹	jag
蛛	jtfy
耍	dmjv
饵	qnbg
烷	opfq
骚	cgcj
枣	smuu
浇	iatq
崩	meef
蹦	khme
褐	pujn
嘎	kdha
俭	wwgg
仑	wxb
窟	pwnm
陡	bfhy
荫	abef
嚼	kelf
倩	wgeg
钦	qqwy
弧	xrcy
涡	ikmw
潭	isjh
坊	fyt
缔	xyuh
廓	oybb
佐	wdag
夷	gxwi
眯	hoy
枕	spqn
捣	rqmh
蹄	khyh
猩	qtjg
狐	qtry
柄	sgmw
穗	tgjn
伞	wufj
拚	rcah
浊	ijy
壶	fpof
冈	mri
搁	rutk
屑	nied
谬	ynwe
拱	rawy
魁	rqcf
祀	pynn
荧	apou
誓	rryf
斋	ydmj
虾	jghy
绸	xmfk
魄	rrqc
娟	vkeg
姊	vtnt
秃	twb
泻	ipgg
鹏	eeqg
蟹	qevj
斌	ygay
灼	oqyy
扛	rag
镁	qugd
瓣	urcu
艘	tuec
捆	rlsy
膏	ypke
苇	afnh
厢	dshd
妮	vnxn
蒲	aisu
啸	kvhw
劈	nkuv
滤	ihny
葱	aqrn
栗	ssu
袍	puqn
耽	bpqn
痴	utdk
颊	gudm
猿	qtfe
沪	iynt
怯	nfcy
垒	cccf
芭	acb
蔑	alaw
絮	vkxi
咯	ktkg
笛	tmf
嘲	kfje
爵	elvf
瞒	hagw
冀	uxlw
赐	mjqr
酿	sgyv
烫	inro
惕	njqr
逗	gkup
挪	rngb
吱	kfcy
淫	ietf
糕	ougo
剿	vjsj
拣	ranw
琼	gyiy
塌	fjng
渣	isjg
澄	iwgu
赠	mulj
媚	vnhg
荐	adhb
暑	jftj
鹤	pwyg
绅	xjhh
讶	yaht
凿	oufb
烁	otni
狮	qtjh
乒	rtr
薛	atnu
侮	wtxy
阎	uqed
嗽	kskw
朦	eape
喃	kfmf
埔	fsy
蝇	jkjn
锣	qlqy
炒	oitt
娶	bcvf
棕	spfi
韧	fnhy
礁	dwyo
陀	bpxn
肆	dvgh
乖	tfux
禄	pyvi
骆	cgtk
驯	cgkh
匙	jghx
萎	atvf
舶	turg
滔	ieeg
卤	hlru
摹	ajdr
昔	ajf
陋	bgmn
雁	dwwy
耿	boy
裳	ipke
崭	mlrj
妆	uvg
勋	kmet
侣	wkkg
闸	ulk
贬	mtpy
痰	uooi
喧	kpgg
膛	eipf
胧	edxy
辫	uxuh
烯	ordh
丫	uhk
铀	qmg
甸	qld
犁	tjtg
幢	mhuf
窑	pwtb
羡	uguw
坪	fguf
缀	xccc
坤	fjhh
汹	irbh
柑	sfg
淹	idjn
杉	set
棺	spng
怖	ndmh
腻	eafy
薯	alfj
锈	qtbt
魅	rqcf
炳	ogmw
洽	iwgk
诵	yceh
咪	koy
椎	swyg
畔	lugh
玫	gty
柿	symh
帜	mhkw
桐	smgk
襟	pusi
筷	tnnw
帆	mhwy
唔	kgkg
匈	qrbk
嵌	mfqw
梳	syck
鳞	qgog
佣	weh
莎	aiit
熄	othn
砌	davt
昧	jfy
噪	kkks
簧	tamw
婉	vpqb
毯	eooi
孵	qytb
憾	ndgn
谎	yayk
坠	bwff
煞	qvto
藉	afsj
嗡	kwcn
绑	xdtb
妖	vtdy
蝴	jdeg
瑰	grqc
揉	rcns
苔	ackf
拌	rugh
莹	apgy
昭	jvkg
汰	idyy
拂	rxjh
嗅	kthd
钮	qnhg
鄙	kflb
撰	rnnw
盏	galf
烘	oawy
谣	yetb
稣	qgty
竿	tfj
皖	rpfq
锥	qwyg
烃	ocag
犬	dgty
喀	kptk
睹	hftj
皂	rab
蔓	ajlc
蕊	annn
疮	uwbv
咒	kkwb
僻	wnku
炯	omkg
寇	pfqc
铭	qqkg
薪	ausr
恍	nigq
辰	dfei
祈	pyrh
迭	tgpi
豁	pdhk
斩	lrh
屡	novd
啼	kyuh
椒	shic
啡	khdd
稽	tdnj
烤	oftn
澡	ikks
籽	obg
洼	iffg
茨	auqw
榴	sqyl
唾	ktgf
巫	awwi
乞	tnb
焊	ojfh
杖	sdyy
贱	mgay
咚	ktuy
蜘	jtdk
扒	rwy
隋	bdae
晌	jtmk
暮	ajdj
涤	itsy
茧	aju
拴	rwgg
闽	uji
叨	kvt
伽	wekg
喳	ksjg
腕	epqb
斧	wrrj
怔	nghg
咖	kekg
啄	kgey
溯	iube
踱	khoc
沦	iwxn
锄	qege
畸	ldsk
脓	epey
疙	utnv
炊	oqwy
擅	rylg
粤	tlon
虏	hee
豹	eqyy
榨	spwf
棱	sfwt
簇	tytd
莺	apqg
撇	rity
绎	xcgh
尉	nfif
柬	sld
涩	ivyh
乓	ryu
觅	emqb
茄	aekf
涯	idff
狩	qtpf
憎	nulj
蔚	anff
挚	rvyr
姥	vftx
袄	putd
捡	rwgg
旷	jot
镶	qyke
碘	dmaw
袜	pugs
丸	vyi
糙	otfp
鲸	qgyi
铵	qpvg
倚	wdsk
矢	tdu
锌	quh
褂	pufh
牡	cfg
硕	ddmy
憨	nbtn
淌	iimk
禾	tttt
尹	vte
荆	agaj
苟	aqkf
聋	dxyb
潇	iavw
庐	oyne
煎	uejo
勿	qre
彬	sset
醋	sgaj
梭	scwt
秉	tvd
嗦	kfpi
掷	rudb
悼	nhjh
噜	kqgj
茵	aldu
蓉	apwk
矫	tdtj
憋	itnu
翘	atgn
琢	ggey
挠	ratq
吭	kywn
兑	ukqb
蔗	aoao
瑟	ggnt
痒	uuk
琐	gimy
酋	usgf
廖	onwe
璋	gujh
槐	srqc
闺	uffd
拧	rpsh
彰	ujet
菱	afwt
呕	kary
瘩	uawk
筐	tagf
搂	rovg
焚	ssou
迄	tnpv
垮	fdfn
缕	xovg
谜	yopy
钥	qeg
嘟	kftb
蠢	dwjj
蛤	jwgk
馈	qnkm
咨	uqwk
敷	syty
缅	xdlf
聂	bccu
宠	pdxy
禧	pyfk
沼	ivkg
巍	mtvc
榆	swgj
宛	pqbb
绷	xeeg
俞	wgej
眶	hagg
吩	kwvt
筛	tjgh
菩	aukf
钞	qitt
诈	ythf
嗨	kitx
葫	adef
佃	wlg
酱	uqsg
颓	twdm
渺	ihit
揽	rjtq
躬	tmdx
歹	gqi
焕	oqmd
啪	krrg
溅	imga
栋	saiy
沛	igmh
砚	dmqn
霖	fssu
囚	lwi
侄	wgcf
妃	vnn
氓	ynna
狡	qtur
瞥	ithf
沁	iny
揣	rmdj
峭	mieg
樱	smmv
禹	tkmy
岔	wvmj
暇	jnhc
檐	sqdy
澜	iusl
涅	ijfg
粥	xoxn
馏	qnql
嗜	kftj
笃	tcgf
麟	oxxg
铲	qutt
寅	pgmw
剔	jqrj
尧	atgq
扼	rdbn
赣	ujtm
稠	tmfk
屿	mgng
胺	epvg
帖	mhhk
堕	bdef
亥	yntw
揪	rtoy
梧	sgkg
麓	ssox
瀑	ijai
窍	pwan
懈	nqeg
淤	iywu
腮	elny
腥	ejtg
绞	xury
鹃	keqg
卒	ywwf
蕉	awyo
枫	swry
脯	esy
腑	eowf
碟	dans
莽	adaj
毙	xxgx
婷	vyps
磕	dfcl
熏	tglo
酵	sgfb
薇	atmt
溴	ithd
弛	xbn
挟	rgud
棘	smsm
秤	tguf
